--{##########}----
--[..a.......]----
--[......a...]----
{#;...d......<###}
[**.....d....*...]
[**.@........*..C]
[**..........*...]
(+:....f.....>+++)
--[.......s..]----
--[..a..s....]----
--[..........]----
--(++++++++++)----