--{##########}----
--[..........]----
--[..........]----
{#;..........<###}
[**..........*...]
[**.@........*..C]
[**..........*...]
(+:..........>+++)
--[.......s..]----
--[.....s....]----
--[..........]----
--(++++++++++)----