{##########}-----
[..........]-----
[..........]-----
[..........<#####
[...!......******
[..........******
[..........******
[......@...>+++++
[.!........]-----
[..........]-----
[..........]-----
(++++++++++)-----