{##########}-----
[..........]-----
[....,.....]-----
[...,,.....<#####
[....,.,...******
[....,.....******
[...,..,...******
[......@...>+++++
[.!........]-----
[..........]-----
[..........]-----
(++++++++++)-----