{##########}-----
[..........]-----
[..........]-----
[.!........<#####
[..........******
[..........******
[..........******
[......@...>+++++
[.!........]-----
[..........]-----
[..........]-----
(++++++++++)-----