############
#..........#
#....,.....#
#...,,.....#
#....,.,...#
#....,.....*
#...,..,...#
#......@...#
#.!........#
#..........#
#..........#
############