{##########}
[..........]
[....,.....]
[...,,.....]
[....,.,...]
[....,.....*
[...,..,...]
[......@...]
[.!........]
[..........]
[..........]
(++++++++++)