{##########}-----
[..........]-----
[..........]-----
[..........<#####
[..........******
[.....!....******
[..........******
[......@...>+++++
[.!........]-----
[..........]-----
[..........]-----
(++++++++++)-----