{##########}-----
[..........]-----
[.....!....]-----
[..........<#####
[....!.....******
[..........******
[..........******
[......@...>+++++
[.!........]-----
[..........]-----
[.......!..]-----
(++++++++++)-----