--{##########}--
--[..&....o..]--
--[.....!....]--
{#;..........<#}
[**....$.....*.]
[**.@........*%]
[**..........*.]
(+:..........>+)
--[.!....&...]--
--[..........]--
--[...$...!..]--
--(++++++++++)--
